000000000000000000
001111111111111100
001222222222222100
001233333333332100
001234444444432100
001234555555432100
001234666666432100
001237777777732100
001288888888882100
001111111111111100
